10 10 1.5 1.5 1.
########## 
#       ##
# ## #  ##
#  # ##  #
## # #   #
## # # # #
#  #   # #
# ## ### #
#        #
##########